WWWWWWWWWWWWWWWWWWWWWWWWWWWWWWWWWWWWWWWWWWWWWWWWW
WWWWWWWWWWWWWW....WWWWWWWWWWWWWWWWWWWWWWWWWWWWWWW
W,,,,WWWWWWWWW....WWWWWWWWWWWWWWWWWWWWWWWWWWWWWWW
W,,,,W................................W.........W
W,,,,E..........................................W
W,,,,W..........................................W
W,,,,WWWWWWWWWWWWWWWWWWWWWWWWWWWW...WWWWWWW.....W
WWWWWWWWWWWWWWWW........W.......W...............W
WWWWWWWWWWWWWWWW........W.......W...............W
WWWWWWWWWWWWWWWW........W.......W...............W
WWWWWWWWWWWWWWWW........W.......WWWWWWWWW.......W
WWWWWWWWWWWWWWWW........F.......................W
WWWWWWWWWWWWWWWW........D.......................W
WWWWWWWWWWWWWWWWWWWWWWWWWWWWWWWWWWWWWWWWWWWWWWWWW
