WWWWWWWWWWWWWWWWWWWWWWWWWWWWW
W.............W.............W
W.............W.............W
W.............W.............W
W.............W.............W
W.............W.............W
W.............W.............W
W.............W.............W
WG............W............GW
WDWWWWWWWWWWWWWWWWWWWWWWWWWDW
W...W...................W...W
W...F...................F...W
W...D...................D...W
WWEWWWWWWWWWWWWWWWWWWWWWWWWWW
W,,,WWWWWWWWWWWWWWWWWWWWWWWWw
W,,,WWWWWWWWWWWWWWWWWWWWWWWww
W,,,WWWWWWWWWWWWWWWWWWWWWWWWw
WWWWWWWWWWWWWWWWWWWWWWWWWWWWw