WWWWWWWWWWWWWWWWWWWWWWWWWWWWWWWWWWWWWWWWWWWWWWWWWWWWWWWWWWWW
W.............................W............................W
E.............................W............................W
W.............................W............................W
WWWWWWWWWWWWWWWWWWWWWWWWWW....W............................W
W.............................W............................W
W.............................W............................W
W..G..........................W............................W
WWWDWWWWWWWWWWWWWWWWWWWWWWWWWWW............................W
W....W..........W....................................WWWWWWW
W....W..........W....................................F.....W
W....W..........W....................................D..G..W
W....WWWWWWW....W.............WWWWWWWWWWWWWWWWWWWWWWWWWWDWWW
W....F..........W.............W............................W
W....D..........W.............W............................W
W....WWWWWWWWWWWWWWWWWWWWWWWWWW............................W
W....W.....................W...............................W
W..........................F...............................W
W........G.................D............WWWWW..............W
WWWWWWWWWDWWWWWWWWWWWWWWWWWW...............................W
W..........................W..............G................W
W..........................WWWWWWWWWWWWWWWDWWWWWWWWWWWWWWWWW
W.............G............W...............W...............W
WWWWWWWWWWWWWWDWWWWWWWWWWWWW...............W...............W
W..........................W...............................W
W..........................W...............................W
WWWWWWWWWWWWWWWWWWWWWWWWWWWWWWWWWWWWWWWWWWWWWWWWWWWWWWWWWWWW
