WWEWWWWWWWWWWWWWWWWWWWWWWWWWWWWWWWWWWWWWWWWWWWWWWWWWWWWWWWWWWWWW
W..............................D.........................D.....W
W..............................D.........................D.....W
W..............................D.........................D.....W
W..............................D.........................D.....W
W..............................D.........................D.....W
W..............................D.........................D.....W
W..............................D.........................D.....W
W..............................D.........................D.....W
W..............................D.........................D.....W
W..............................D.........................D.....W
W..............................D.........................D.....W
W..............................D.........................D.....W
W..............................D.........................D.....W
W.................W............W.........................W.....W
W.................W............W.........................W.....W
WWWWWWW..WWWWWWWWWWWWWWWWWDWWWWWWWWWWWWWWWWWWWWWWWWWWWWWWWWWWWWW
W.................W............W.........W...............W.....W
W.................W............D.........W...............W.....W
W..............................W.........W...............W.....W
W..............................W.........W...............W.....W
W..............................W.........W...............W.....W
W..............................W.........W...............W.....W
W..............................W.........W...............W.....W
W..............................W.........W...............W.....W
W..............................W.........W...............W.....W
W..............................W.........W...............W.....W
W..............................W.........W...............W.....W
W..............................W.........W...............W.....W
W..............................W.........W...............W.....W
W..............................W.........W...............W.....W
W..............................W.........D...............W.....W
W..............................WWWWWWWWWWW...............D.....W
WWWWWWW...WWWWWWWWWWWWWWWWWWWWWWWWWWWWWWWWWWWWWWWWWWWWWWWWWWWWWW
W........................................................D.....W
W........................................................D.....W
W........................................................D.....W
W........................................................D.....W
W........................................................D.....W
W........................................................D.....W
W........................................................D.....W
W........................................................D.....W
W........................................................D.....W
W........................................................D.....W
W........................................................D.....W
W........................................................D.....W
W........................................................D.....W
W........................................................W.....W
WWWWWWWWWWWWWWWWWWWWWWWWWWWWWWWWWWWWWWWWWWWWWWWWWWWWWWWWWWWWWWWW
