WWEWWWWWWWWWWWWWWWWWWWWWWWWWWWWWWWWWWWWWWWWWWWWWWWWWWWWWWWWWWWWW
W....W........................D.........................D......W
W....W.......................D.........................D.......W
W....W........................D.........................D......W
WDDWWWWWWWWWWWWWWWWWWWWWWWWWWWWWWWWWWWWWWWWWWWWWWWWWWWWWWWWWWWWW
W............W.................D.........................D.....W
W............W.................D.........................D.....W
W............W.................D.........................D.....W
WWWWWDDWWWWWWWWWWWWWWWWWWWWWWWWWWWWWWWWWWWWWWWWWWWWWWWWWWWWWWWWW
W........W........W............D.........................D.....W
W.....WWWW........W............D.........................D.....W
W.....W...........W............D.........................D.....W
W.................W............D.........................D.....W
WWW.......W.......D............D.........................D.....W
W.........W.......D............D.........................D.....W
W....WW...W.......W...........D..........................D.....W
W.........W.......W...........D..........................D.....W
WWWWWWWWWWW.......W............D.........................D.....W
W..............................D.........................D.....W
W..............................D.........................D.....W
W..............................D.........................D.....W
W.................W............W.........................W.....W
W.................W............W.........................W.....W
WWWWWWW..WWWWWWWWWWWWWWWWWDWWWWWWWWWWWWWWWWWWWWWWWWWWWWWWWWWWWWW
W.................W............W.........W...............W.....W
W.................W............D.........W...............W.....W
W..............................W.........W...............W.....W
W..............................W.........W...............W.....W
W..............................W.........W...............W.....W
W..............................W.........W...............W.....W
W..............................W.........W...............W.....W
W..............................W.........W...............W.....W
W..............................W.........W...............W.....W
W..............................W.........W...............W.....W
W..............................W.........W...............W.....W
W..............................W.........W...............W.....W
W..............................W.........W...............W.....W
W..............................W.........W...............W.....W
W..............................W.........D...............W.....W
W..............................WWWWWWWWWWW...............D.....W
WWWWWWW...WWWWWWWWWWWWWWWWWWWWWWWWWWWWWWWWWWWWWWWWWWWWWWWWWWWWWW
W........................................................D.....W
W........................................................D.....W
W........................................................D.....W
W........................................................D.....W
W........................................................D.....W
W........................................................D.....W
W........................................................D.....W
W........................................................D.....W
W........................................................D.....W
W........................................................D.....W
W........................................................D.....W
W........................................................D.....W
W........................................................D.....W
W........................................................W.....W
WWWWWWWWWWWWWWWWWWWWWWWWWWWWWWWWWWWWWWWWWWWWWWWWWWWWWWWWWWWWWWWW
