WWEWWWWWWWWWWWWWWWWWWWWWWWWWWWWWWWWWWWWWWWWWWWWWWWWWWWWWWWWWWWWW
W....W........................D.........................D......W
W....W.......................D.........................D.......W
W....W........................D.........................D......W
WDDWWWWWWWWWWWWWWWWWWWWWWWWWWWWWWWWWWWWWWWWWWWWWWWWWWWWWWWWWWWWW
W............W.................D.........................D.....W
W............W.................D.........................D.....W
W............W.................D.........................D.....W
WWWWWDDWWWWWWWWWWWWWWWWWWWWWWWWWWWWWWWWWWWWWWWWWWWWWWWWWWWWWWWWW
W......W.......................D.........................D.....W
W.....WW.......................D.........................D.....W
W.....W........................D.........................D.....W
W..............................D.........................D.....W
WWW............................D.........................D.....W
W..............................D.........................D.....W
W..............................D.........................D.....W
W..............................D.........................D.....W
W..............................D.........................D.....W
W..............................D.........................D.....W
W..............................D.........................D.....W
W..............................D.........................D.....W
W.................W............W.........................W.....W
W.................W............W.........................W.....W
WWWWWWW..WWWWWWWWWWWWWWWWWDWWWWWWWWWWWWWWWWWWWWWWWWWWWWWWWWWWWWW
W.................W............W.........W...............W.....W
W.................W............D.........W...............W.....W
W..............................W.........W...............W.....W
W..............................W.........W...............W.....W
W..............................W.........W...............W.....W
W..............................W.........W...............W.....W
W..............................W.........W...............W.....W
W..............................W.........W...............W.....W
W..............................W.........W...............W.....W
W..............................W.........W...............W.....W
W..............................W.........W...............W.....W
W..............................W.........W...............W.....W
W..............................W.........W...............W.....W
W..............................W.........W...............W.....W
W..............................W.........D...............W.....W
W..............................WWWWWWWWWWW...............D.....W
WWWWWWW...WWWWWWWWWWWWWWWWWWWWWWWWWWWWWWWWWWWWWWWWWWWWWWWWWWWWWW
W........................................................D.....W
W........................................................D.....W
W........................................................D.....W
W........................................................D.....W
W........................................................D.....W
W........................................................D.....W
W........................................................D.....W
W........................................................D.....W
W........................................................D.....W
W........................................................D.....W
W........................................................D.....W
W........................................................D.....W
W........................................................D.....W
W........................................................W.....W
WWWWWWWWWWWWWWWWWWWWWWWWWWWWWWWWWWWWWWWWWWWWWWWWWWWWWWWWWWWWWWWW
