WWEWWWWWWWWWWWWWWWWWWWWWWWWWWWWWWWWWWWWWWWWWWWWWWWWWWWWWWWWWWWWW
W....W........................D.........................D......W
W....W.......................D.........................D.......W
W.G..W........................D.........................D......W
WWDWWWWWWWWWWWWWWWWWWWWWWWWWWWWWWWWWWWWWWWWWWWWWWWWWWWWWWWWWWWWW
W............W.................W.........................D.....W
W............W.................F.........................D.....W
W.....G......W.................D.........................D.....W
WWWWWWDWWWWWWWWWWWWWWWWWWWWWWWWWWWWWWWWWWWWWWWWWWWWWWWWWWWWWWWWW
W........W........W........W...W.........................D.....W
W.....WWWW........W........W...W.........................D.....W
W.....W...........W........W...D.........................D.....W
W.................W........W...D.........................D.....W
WWW.......W.......F........W...W.........................D.....W
W.........W.......D........W...W.........................D.....W
W....WW...W.......W........D...W.........................D.....W
W.........W.......W........D...W.........................D.....W
WWWWWWWWWWW.......WWWWWWDDWW...W.........................D.....W
W..............................W.........................D.....W
W..............................W.........................D.....W
WWWWWWWWWWWWWWWWWWWWWWWWWWDDWWWWWWWWWWWWWWWWWWWWWWWWWWWWWWWWWWWW
W..............................D.........................D.....W
W.................W............W.........................W.....W
W.................W............W.........................W.....W
WWWWWWW..WWWWWWWWWWWWWWWWWDWWWWWWWWWWWWWWWWWWWWWWWWWWWWWWWWWWWWW
W.................W............W.........W...............W.....W
W.................W............D.........W...............W.....W
W..............................W.........W...............W.....W
W..............................W.........W...............W.....W
W..............................W.........W...............W.....W
W..............................W.........W...............W.....W
W..............................W.........W...............W.....W
W..............................W.........W...............W.....W
W..............................W.........W...............W.....W
W..............................W.........W...............W.....W
W..............................W.........W...............W.....W
W..............................W.........W...............W.....W
W..............................W.........W...............W.....W
W..............................W.........W...............W.....W
W..............................W.........D...............W.....W
W..............................WWWWWWWWWWW...............D.....W
WWWWWWW...WWWWWWWWWWWWWWWWWWWWWWWWWWWWWWWWWWWWWWWWWWWWWWWWWWWWWW
W........................................................D.....W
W........................................................D.....W
W........................................................D.....W
W........................................................D.....W
W........................................................D.....W
W........................................................D.....W
W........................................................D.....W
W........................................................D.....W
W........................................................D.....W
W........................................................D.....W
W........................................................D.....W
W........................................................D.....W
W........................................................D.....W
W........................................................W.....W
WWWWWWWWWWWWWWWWWWWWWWWWWWWWWWWWWWWWWWWWWWWWWWWWWWWWWWWWWWWWWWWW
