WWWWWWWWWWWWWWWWWWWWWWWWWWWWWWWWW
WWWWWWWWWWWWWWW,,,WWWWWWWWWWWWWWW
WWWWWWWWWWWWWWW,,,WWWWWWWWWWWWWWW
WWWWWWWWWWWWWWW,,,WWWWWWWWWWWWWWW
WWWWWWWWWWWWWWWWEWWWWWWWWWWWWWWWW
W...............................W
WG.............G...............GW
WDWWWWWWWWWWWWWDWWWWWWWWWWWWWWWDW
W..WWWWWWWWWW.......WWWWWWWWWW..W
W..WWWWWWWWWW.......WWWWWWWWWW..W
W...WWWWWWWWW.......WWWWWWWWW...W
W...WWWWWWWWW.......WWWWWWWWW...W
W..WWWWWWWWWW.......WWWWWWWWWW..W
W..WWWWWWWWWW.......WWWWWWWWWW..W
W...WWWWWWWWW.......WWWWWWWWW...W
W...WWWWWWWWW.......WWWWWWWWW...W
WWWWWWWWWWWWW.......WWWWWWWWWWWWW
WWWWWWWWWWWWW.......WWWWWWWWWWWWW
WWWWWWWWWWWWWWWWWWWWWWWWWWWWWWWWW
