WWWWWWWWWWWWWWWWWWWWWWWWWWWWWWWWWWWWWWWWWWWWWWWWWWWWWWWWWWWW
W.............................W............................W
E.............................W............................W
W.............................W............................W
WWWWWWWWWWWWWWWWWWWWWWWWWW....W............................W
W.............................W............................W
W.............................W............................W
W..G..........................W............................W
WWWDWWWWWWWWWWWWWWWWWWWWWWWWWWW............................W
W....W..........W..........................................W
W....W..........W..........................................W
W....W..........W...................................WWWWWWWW
W....WWWWWWW....W...................................W......W
W....F..........W...................................W......W
W....D..........W.......................................G..W
W....WWWWWWWWWWWWWWWWWWWWWWWWWWWWWWWWWWWWWWWWWWWWWWWWWWWDWWW
W....W.....................W.........W.....................W
W..........................F...............................W
W........G.................D...............................W
WWWWWWWWWDWWWWWWWWWWWWWWWWWW...............................W
W..........................W..............G................W
W..........................WWWWWWWWWWWWWWWDWWWWWWWWWWWWWWWWW
W.............G............W...............W...............W
WWWWWWWWWWWWWWDWWWWWWWWWWWWW...............W...............W
W..........................W...............................W
W..........................W...............................W
WWWWWWWWWWWWWWWWWWWWWWWWWWWWWWWWWWWWWWWWWWWWWWWWWWWWWWWWWWWW
