WWWWWWWWWWWWWWWWWWWWWWWWWWWWWWWWW
WWWWWWWWWWWWWWW,,,WWWWWWWWWWWWWWW
WWWWWWWWWWWWWWW,,,WWWWWWWWWWWWWWW
WWWWWWWWWWWWWWW,,,WWWWWWWWWWWWWWW
WWWWWWWWWWWWWWWWEWWWWWWWWWWWWWWWW
W...............................W
WG.............G...............GW
WDWWWWWWWWWWWWWDWWWWWWWWWWWWWWWDW
W..WW.......W.......W.......WW..W
W..WW.......W.......W.......WW..W
W...W.......W.......W.......W...W
W...W.......W.......W.......W...W
W..WW.......W.......W.......WW..W
W..WW.......W.......W.......WW..W
W...W.......W.......W.......W...W
W...W.......W.......W.......W...W
WWWWWWWWWWWWWWWWWWWWWWWWWWWWWWWWW
