WWWWWWWWWWWWWWWWWWWWWWWWWWWWWWWWW
WWWWWWWWWWWWWWW,,,WWWWWWWWWWWWWWW
WWWWWWWWWWWWWWW,,,WWWWWWWWWWWWWWW
WWWWWWWWWWWWWWW,,,WWWWWWWWWWWWWWW
WWWWWWWWWWWWWWWWEWWWWWWWWWWWWWWWW
W..............................WW
WG.............G...............GW
WDWWWWWWWWWWWWWDWWWWWWWWWWWWWwWDW
W..WW.......W.......W.......WW..W
W..WW.......W.......W.......WW..W
W...W.......W.......W.......W...W
W...W.......W.......W.......W...W
W..WW.......W.......W.......WW..W
W..WW.......W.......W.......WW..W
W...W.......W.......W.......W...W
W...W.......W.......W.......W...W
WWWWWWWWWWWWWWWWWWWWWWWWWWWWWWWWW
