WWEWWWWWWWWWWWWWWWWWWWWWWWWWWWWWWWWWWWWWWWWWWWWWWWWWWWWWWWWWWWWW
W..............................D.........................D.....W
W.................W............W.........................W.....W
W.................W............W.........................W.....W
WWWWWWWDWWWWWWWWWWWWWWWWWWDWWWWWWWWWWWWWWWWWWWWWWWWWWWWWWWWWWWWW
W.................W............W.........W...............W.....W
W.................W............D.........W...............W.....W
W..............................W.........W...............W.....W
W..............................W.........W...............W.....W
W..............................W.........D...............W.....W
W..............................WWWWWWWWWWW...............D.....W
WWWWWWWWWWWWWWWWWWWWWWWWWWWWWWWWWWWWWWWWWWWWWWWWWWWWWWWWWWWWWWWW
W........................................................D.....W
W........................................................W.....W
WWWWWWWWWWWWWWWWWWWWWWWWWWWWWWWWWWWWWWWWWWWWWWWWWWWWWWWWWWWWWWWW
